[


8,0,0,0,0,0,0,0,0,0,0,0,0,0,0,0,0,0,0,0,0,0,0,0,0,0,16,0,0,0,0,0,0,0,0,0,0,0,0,
8,0,0,0,0,0,0,0,0,0,0,0,0,0,0,0,0,0,0,0,0,0,0,0,8,0,16,0,0,0,0,0,0,0,0,0,0,0,0,
8,0,0,0,0,0,0,0,0,0,0,0,0,0,0,0,0,0,0,0,0,0,0,8,0,0,16,0,0,0,0,0,0,0,0,0,0,0,0,
8,0,0,0,0,0,0,0,0,0,0,0,0,0,0,0,0,0,0,0,0,8,8,0,0,0,16,0,0,0,0,0,0,0,0,0,0,0,0,
8,0,0,0,0,0,0,0,0,40,0,0,0,0,0,0,0,0,0,0,8,32,32,32,32,32,16,32,32,32,32,32,32,32,32,32,32,32,32,
8,8,8,8,8,8,8,8,8,8,32,32,32,32,32,32,32,8,8,8,8,8,8,8,8,8,16,8,8,8,8,8,8,8,8,8,8,8,8,
0,0,0,0,0,0,0,0,0,0,0,0,0,0,0,0,0,0,0,0,0,0,0,0,0,0,16,0,0,0,0,0,0,0,0,0,0,0,0,
0,0,0,256,0,0,0,0,0,0,0,0,0,0,0,0,0,0,0,0,0,0,0,0,0,0,16,0,0,0,0,0,0,0,0,25,0,48,0,
8,24,8,8,8,8,8,8,32,8,8,8,8,8,8,8,8,0,0,48,48,0,0,0,0,0,8,8,8,8,8,8,8,8,8,8,8,8,8,


]



[

0,0,0,0,0,0,0,0,0,0,0,16,0,0,0,0,0,0,0,0,0,0,0,
0,0,0,0,0,0,0,0,0,0,0,16,0,0,0,0,0,0,0,0,0,0,0,
0,0,0,0,0,0,0,0,0,0,0,16,0,0,0,0,0,0,0,0,0,0,0,
0,48,0,280,0,272,272,0,0,0,256,16,0,0,0,0,0,0,0,0,0,0,0,
8,8,8,8,8,8,8,8,0,0,8,8,8,8,24,0,0,0,0,0,0,0,0,
0,0,0,0,0,0,0,0,0,0,0,0,0,0,0,0,0,0,264,0,0,40,0,
0,0,0,0,0,0,0,0,0,0,0,0,0,0,0,0,0,0,9,9,25,9,0,
0,0,0,0,0,0,0,0,0,0,0,0,0,0,0,0,0,0,0,0,0,0,0,
0,0,0,0,0,0,0,0,0,0,0,0,0,0,0,0,0,0,0,0,0,0,0,
0,0,0,0,0,0,0,0,0,0,0,0,0,0,0,0,0,0,0,0,0,0,0,

]




